{
	"numX": 13,
	"numY": 9,
	"size": [3.1, 1.5],
	"start": [1.5, 0.0],
	"tileNames":["", "BoxPro", "SparklePro", "WallPro", "NukePro", "TilePro", "EnemyPro"],
	"tiles": [3, 1, 0, 1, 0, 1, 0, 1, 1, 0, 1, 0, 3,
			  3, 5, 5, 0, 1, 0, 0, 0, 0, 4, 5, 5, 3,
			  3, 1, 1, 5, 5, 0, 0, 0, 1, 5, 1, 0, 3,
			  3, 0, 0, 1, 0, 0, 0, 6, 0, 1, 0, 1, 3,
			  3, 6, 0, 0, 0, 0, 0, 0, 5, 0, 0, 0, 3,
			  3, 0, 5, 0, 0, 0, 0, 0, 0, 0, 0, 0, 3,
			  3, 0, 0, 5, 5, 0, 0, 0, 0, 4, 0, 0, 3,
			  3, 4, 0, 0, 0, 6, 0, 5, 5, 5, 0, 0, 3,
			  3, 0, 0, 0, 0, 0, 0, 0, 0, 0, 0, 0, 3]
}